NO	     XPM/NORTH.xpm
SO     XPM/SOUTH.xpm
      WE 				XPM/WEST.xpm
EA   		XPM/EAST.xpm
		
   
   
  

F       165,196,185
C 	190,208,175


11111111111111111
10100010S01000101
10100011001000101
10001110100010001
10001000110010101
10101010001000101
10101010001111101
10001110100010001
10001000100010001
10100010001000101
10101010001000101
10001000111110001
10001000100010001
11111111111111111