NO	     XPM/NORTH.xpm
SO     XPM/SOUTH.xpm
      WE 				XPM/WEST.xpm
EA   		XPM/EAST.xpm
		
   
   
  

F       165,196,185
C 	190,208,175


1111111
1110111
1110111
1110111
1000001
100N001
1000001
1110111
1110111
1110111
1111111