
NO	     path_to_the_north_texture.xpm
SO     path_to_the_south_texture.xpm  
      WE 				path_to_the_west_texture.xpm
EA   		path_to_the_east_texture.xpm
		
   
   
  

F       220,100,0
C 	0,30,45

1111111
100000011
111W000001
101010011
100010001
110000001
11111111

										