
NO	     path_to_the_north_texture.xpm
SO     path_to_the_south_texture.xpm  
      WE 				path_to_the_west_texture.xpm
EA   		path_to_the_east_texture.xpm
		
   
   
  

F       220,100,0
C 	0,30,45

       1111111111111111111111111
      100000000000000000000000001
     10000000000000E00000000000001
    1000000000000000000000000000001
   100000000011111111111110000000001
  10000000001             10000000001
 10000000001               10000000001
10000000001                 10000000001 
11110111111                 11110111111
   101                         101                           
   101                         101
   101                         101
   101                         101
11110111111                 11110111111
10000000001                 10000000001
 10000000001               10000000001
  10000000001             10000000001
   100000000011111111111110000000001
    1000000000000000000000000000001
     10000000000000000000000000001
      100000000000000000000000001
       1111111111111111111111111




										